&&&&&&&&&&&&&&%&&&&%&&&&&&&&&&
&[[           |    |         &
&--  |        |    |         &
&    |   %    %    %    %    &
\    |&''                    \
/    |&,,                    /
&    |   %    %    %    %    &
&    |                       &
&                            &
&&&&&&&&&&&&&&&&&&&&&&&&&&&&&&