&&&&&&&&&&&&&&&&&&&&&&&&&&&&&&&&&
&]]                             &
&&&    %    %    %    %    %    &
&                               &
&      &    %    %    %    %    &
&      &         &&&&&&&&&&&&&&&&
&      &                        &
&      &    %    %    %       &&&
&      &                      ]]&
&&&&&&&&&&&&&&&&&&&&&&&&&&&&&&&&&