|                                                   
|          &                                        
|       & &                     &&  &               
|       &            &           &                  
|              &     &             &                
|                                                   
|                                                   
|      &&                            &              
#      &            &      & &     &                
\          &&       &&                        &     
/        &&                 &&                  &   
#                                         &  &      
|                                                   
|             &      &        &  & &                
|            &&       &         &                   
|          &&                &&                     
|                            && &                   
|                           &  &                    
|                                                   
|                                                   