----------------------------------------
|  \#######/        \#######/          |
|  #########        #########          |
|  /#######\        /#######\          |
|                                      |
&                                      |
&                                      |
&                                      |
&                                      #
\                 +--+                 /
/                 |##|                 \
&                 +--+                 #
&                                      |
&                                      |
&                                      |
|                                      |
|   \#######/  \#######/  \#######/    |
|   #########  #########  #########    |
|   /#######\  /#######\  /#######\    |
----------------------------------------